//MAP CONVERTED BY dmm2tgm.py THIS HEADER COMMENT PREVENTS RECONVERSION, DO NOT REMOVE
"ap" = (
/obj/structure/table,
/obj/item/storage/toolbox/mechanical,
/obj/item/multitool,
/obj/effect/decal/cleanable/dirt,
/obj/effect/decal/cleanable/dirt,
/turf/open/floor/plasteel,
/area/shuttle/caravan/freighter4)
"ax" = (
/obj/structure/closet/crate,
/obj/item/stack/sheet/mineral/silver{
	amount = 25
	},
/obj/item/stack/sheet/mineral/silver{
	amount = 25
	},
/turf/open/floor/plasteel/dark,
/area/shuttle/caravan/freighter4)
"aP" = (
/obj/machinery/door/airlock{
	name = "Crew Quarters"
	},
/obj/machinery/atmospherics/pipe/simple/supply/hidden{
	dir = 4
	},
/obj/effect/decal/cleanable/dirt,
/turf/open/floor/plasteel,
/area/shuttle/caravan/freighter4)
"bg" = (
/obj/machinery/airalarm/all_access{
	pixel_y = 24
	},
/obj/machinery/atmospherics/pipe/manifold/supply/hidden{
	dir = 1
	},
/turf/open/floor/plasteel,
/area/shuttle/caravan/freighter4)
"bu" = (
/obj/machinery/door/airlock{
	name = "Crew Cabins"
	},
/obj/effect/decal/cleanable/dirt,
/obj/machinery/atmospherics/pipe/simple/supply/hidden{
	dir = 4
	},
/obj/effect/decal/cleanable/dirt,
/turf/open/floor/plasteel/airless,
/area/shuttle/caravan/freighter4)
"bI" = (
/obj/machinery/light/small,
/obj/effect/turf_decal/box/white/corners,
/obj/machinery/button/door{
	id = "merchant_cargo";
	name = "Cargo Blast Door Control";
	pixel_y = -24
	},
/obj/structure/closet/crate,
/obj/item/stack/sheet/mineral/diamond{
	amount = 5
	},
/turf/open/floor/plasteel/dark,
/area/shuttle/caravan/freighter4)
"bR" = (
/obj/structure/toilet{
	dir = 4
	},
/obj/structure/sink{
	pixel_y = 24
	},
/obj/machinery/light/small,
/obj/effect/decal/cleanable/dirt,
/obj/effect/decal/cleanable/dirt,
/turf/open/floor/plasteel/showroomfloor{
	initial_gas_mix = "TEMP=2.7"
	},
/area/shuttle/caravan/freighter4)
"cx" = (
/obj/machinery/atmospherics/pipe/simple/supply/hidden{
	dir = 4
	},
/obj/effect/turf_decal/tile/yellow{
	dir = 4
	},
/turf/open/floor/plasteel{
	initial_gas_mix = "TEMP=2.7"
	},
/area/shuttle/caravan/freighter4)
"cX" = (
/obj/structure/chair/stool,
/obj/effect/turf_decal/tile/yellow,
/obj/effect/turf_decal/tile/yellow{
	dir = 4
	},
/turf/open/floor/plasteel{
	initial_gas_mix = "TEMP=2.7"
	},
/area/shuttle/caravan/freighter4)
"ec" = (
/obj/effect/decal/cleanable/dirt,
/obj/machinery/atmospherics/pipe/simple/supply/hidden,
/turf/open/floor/plating,
/area/shuttle/caravan/freighter4)
"fk" = (
/obj/effect/decal/cleanable/dirt,
/obj/machinery/atmospherics/pipe/manifold/supply/hidden,
/obj/machinery/meter,
/turf/open/floor/plating,
/area/shuttle/caravan/freighter4)
"gs" = (
/obj/structure/closet/secure_closet/freezer{
	locked = 0;
	name = "fridge"
	},
/obj/item/reagent_containers/food/drinks/beer{
	pixel_x = -3;
	pixel_y = 3
	},
/obj/item/reagent_containers/food/drinks/beer,
/obj/item/reagent_containers/food/drinks/beer{
	pixel_x = 3;
	pixel_y = -3
	},
/obj/item/reagent_containers/glass/beaker/waterbottle{
	pixel_x = -3;
	pixel_y = 3
	},
/obj/item/reagent_containers/glass/beaker/waterbottle,
/obj/item/reagent_containers/glass/beaker/waterbottle{
	pixel_x = 3;
	pixel_y = -3
	},
/obj/item/reagent_containers/food/snacks/pizzaslice/margherita{
	pixel_x = -3;
	pixel_y = 3
	},
/obj/item/reagent_containers/food/snacks/pizzaslice/margherita,
/obj/item/reagent_containers/food/snacks/chocolatebar,
/obj/effect/turf_decal/tile/yellow{
	dir = 1
	},
/obj/effect/turf_decal/tile/yellow,
/obj/effect/turf_decal/tile/yellow{
	dir = 4
	},
/turf/open/floor/plasteel{
	initial_gas_mix = "TEMP=2.7"
	},
/area/shuttle/caravan/freighter4)
"gw" = (
/obj/structure/chair/comfy/shuttle{
	dir = 4
	},
/obj/effect/decal/cleanable/dirt,
/obj/effect/turf_decal/tile/blue,
/turf/open/floor/plasteel/dark{
	initial_gas_mix = "TEMP=2.7"
	},
/area/shuttle/caravan/freighter4)
"jg" = (
/obj/machinery/door/airlock{
	name = "Restroom"
	},
/obj/effect/decal/cleanable/dirt,
/turf/open/floor/plasteel/showroomfloor{
	initial_gas_mix = "TEMP=2.7"
	},
/area/shuttle/caravan/freighter4)
"lt" = (
/obj/structure/closet/crate,
/obj/item/stack/sheet/metal/twenty,
/obj/item/stack/sheet/glass{
	amount = 10
	},
/obj/item/stack/rods/ten,
/obj/item/storage/box/lights/bulbs,
/obj/effect/decal/cleanable/dirt,
/obj/effect/turf_decal/stripes/line{
	dir = 6
	},
/turf/open/floor/plating,
/area/shuttle/caravan/freighter4)
"lx" = (
/obj/effect/turf_decal/box/white/corners{
	dir = 1
	},
/turf/open/floor/plasteel,
/area/shuttle/caravan/freighter4)
"lC" = (
/obj/machinery/power/port_gen/pacman{
	anchored = 1
	},
/obj/item/wrench,
/obj/machinery/power/terminal,
/obj/effect/turf_decal/stripes/line{
	dir = 5
	},
/obj/effect/decal/cleanable/dirt,
/turf/open/floor/plating,
/area/shuttle/caravan/freighter4)
"lM" = (
/obj/machinery/light/small{
	dir = 8
	},
/obj/structure/sign/warning/vacuum{
	pixel_x = 32
	},
/turf/open/floor/plating,
/area/shuttle/caravan/freighter4)
"mo" = (
/obj/structure/shuttle/engine/heater{
	dir = 8
	},
/obj/structure/window/reinforced{
	dir = 4
	},
/turf/open/floor/plating/airless,
/area/shuttle/caravan/freighter4)
"mw" = (
/obj/machinery/light/small{
	dir = 8
	},
/obj/machinery/firealarm{
	dir = 8;
	pixel_x = -24
	},
/obj/effect/decal/cleanable/dirt,
/obj/structure/rack,
/obj/item/storage/toolbox/emergency,
/obj/item/wrench,
/obj/effect/turf_decal/tile/blue{
	dir = 1
	},
/obj/effect/turf_decal/tile/blue{
	dir = 4
	},
/obj/effect/turf_decal/tile/blue{
	dir = 8
	},
/turf/open/floor/plasteel/dark{
	initial_gas_mix = "TEMP=2.7"
	},
/area/shuttle/caravan/freighter4)
"mZ" = (
/obj/effect/decal/cleanable/dirt,
/obj/effect/turf_decal/tile/blue{
	dir = 1
	},
/obj/effect/turf_decal/tile/blue{
	dir = 4
	},
/obj/effect/turf_decal/tile/blue{
	dir = 8
	},
/obj/machinery/computer/camera_advanced/shuttle_docker/merchant{
	dir = 8
	},
/turf/open/floor/plasteel/dark{
	initial_gas_mix = "TEMP=2.7"
	},
/area/shuttle/caravan/freighter4)
"oj" = (
/obj/effect/decal/cleanable/dirt,
/obj/machinery/atmospherics/pipe/manifold/supply/hidden{
	dir = 1
	},
/turf/open/floor/plating,
/area/shuttle/caravan/freighter4)
"ot" = (
/obj/effect/turf_decal/box/white/corners{
	dir = 4
	},
/turf/open/floor/plasteel/dark,
/area/shuttle/caravan/freighter4)
"pR" = (
/obj/machinery/light/small,
/obj/effect/decal/cleanable/dirt,
/obj/machinery/atmospherics/pipe/simple/supply/hidden{
	dir = 4
	},
/obj/effect/turf_decal/tile/yellow{
	dir = 1
	},
/obj/effect/turf_decal/tile/yellow{
	dir = 4
	},
/turf/open/floor/plasteel{
	initial_gas_mix = "TEMP=2.7"
	},
/area/shuttle/caravan/freighter4)
"qp" = (
/obj/effect/decal/cleanable/dirt,
/obj/machinery/atmospherics/pipe/manifold/supply/hidden,
/obj/effect/turf_decal/tile/blue,
/obj/effect/turf_decal/tile/blue{
	dir = 4
	},
/turf/open/floor/plasteel{
	initial_gas_mix = "TEMP=2.7"
	},
/area/shuttle/caravan/freighter4)
"qM" = (
/obj/machinery/airalarm/all_access{
	dir = 4;
	pixel_x = -24
	},
/obj/effect/decal/cleanable/dirt,
/obj/machinery/atmospherics/components/unary/vent_pump/on,
/turf/open/floor/plasteel/dark,
/area/shuttle/caravan/freighter4)
"rF" = (
/obj/machinery/atmospherics/pipe/manifold/supply/hidden{
	dir = 8
	},
/obj/effect/decal/cleanable/dirt,
/turf/open/floor/plasteel,
/area/shuttle/caravan/freighter4)
"sf" = (
/obj/machinery/light{
	dir = 1
	},
/obj/structure/table,
/obj/item/stack/packageWrap,
/obj/item/crowbar,
/obj/item/flashlight{
	pixel_x = 1;
	pixel_y = 5
	},
/obj/machinery/airalarm/all_access{
	pixel_y = 24
	},
/obj/effect/decal/cleanable/dirt,
/turf/open/floor/plasteel,
/area/shuttle/caravan/freighter4)
"si" = (
/obj/effect/mapping_helpers/airlock/cyclelink_helper{
	dir = 1
	},
/obj/machinery/door/airlock/external{
	id_tag = "caravantrade1_bolt"
	},
/turf/open/floor/plating,
/area/shuttle/caravan/freighter4)
"ss" = (
/obj/structure/rack,
/obj/item/storage/belt/utility,
/obj/structure/extinguisher_cabinet{
	pixel_y = 29
	},
/obj/effect/decal/cleanable/dirt,
/obj/effect/decal/cleanable/dirt,
/turf/open/floor/plasteel,
/area/shuttle/caravan/freighter4)
"tg" = (
/obj/effect/turf_decal/box/white/corners{
	dir = 8
	},
/obj/effect/decal/cleanable/dirt,
/turf/open/floor/plasteel/dark,
/area/shuttle/caravan/freighter4)
"ur" = (
/obj/machinery/door/firedoor,
/obj/machinery/atmospherics/pipe/simple/supply/hidden{
	dir = 4
	},
/obj/machinery/door/airlock/engineering{
	name = "Engine Room"
	},
/turf/open/floor/plating,
/area/shuttle/caravan/freighter4)
"uA" = (
/obj/machinery/light/small,
/obj/effect/decal/cleanable/dirt,
/obj/machinery/airalarm/all_access{
	dir = 8;
	pixel_x = 24
	},
/obj/machinery/button/door{
	id = "caravantrade1_cabin1";
	name = "Cabin Bolt Control";
	normaldoorcontrol = 1;
	pixel_x = -25;
	pixel_y = 6;
	specialfunctions = 4
	},
/obj/machinery/atmospherics/components/unary/vent_pump/on{
	dir = 1
	},
/obj/effect/turf_decal/tile/neutral{
	dir = 1
	},
/obj/effect/turf_decal/tile/neutral,
/obj/effect/turf_decal/tile/neutral{
	dir = 4
	},
/obj/effect/turf_decal/tile/neutral{
	dir = 8
	},
/obj/effect/mob_spawn/human/merchant,
/turf/open/floor/plasteel/dark,
/area/shuttle/caravan/freighter4)
"vt" = (
/obj/structure/shuttle/engine/propulsion/burst{
	dir = 8
	},
/turf/open/floor/plating/airless,
/area/shuttle/caravan/freighter4)
"xz" = (
/obj/effect/turf_decal/box/white/corners{
	dir = 4
	},
/turf/open/floor/plasteel,
/area/shuttle/caravan/freighter4)
"yn" = (
/obj/structure/closet/crate,
/obj/item/stack/sheet/mineral/titanium{
	amount = 20
	},
/obj/item/stack/sheet/mineral/titanium{
	amount = 20
	},
/turf/open/floor/plasteel/dark,
/area/shuttle/caravan/freighter4)
"yC" = (
/obj/machinery/button/door{
	id = "caravantrade1_bolt";
	name = "External Bolt Control";
	normaldoorcontrol = 1;
	pixel_x = -25;
	pixel_y = 8;
	specialfunctions = 4
	},
/obj/machinery/atmospherics/components/unary/vent_pump/on,
/obj/effect/turf_decal/tile/blue,
/turf/open/floor/plasteel{
	initial_gas_mix = "TEMP=2.7"
	},
/area/shuttle/caravan/freighter4)
"zd" = (
/obj/effect/turf_decal/bot,
/obj/machinery/atmospherics/components/unary/tank/air{
	dir = 4
	},
/obj/effect/decal/cleanable/dirt,
/turf/open/floor/plating,
/area/shuttle/caravan/freighter4)
"Ax" = (
/turf/open/floor/plasteel/dark,
/area/shuttle/caravan/freighter4)
"AM" = (
/obj/machinery/door/firedoor,
/obj/machinery/atmospherics/pipe/simple/supply/hidden{
	dir = 4
	},
/obj/machinery/door/airlock/command{
	name = "Bridge"
	},
/turf/open/floor/plasteel/dark,
/area/shuttle/caravan/freighter4)
"AX" = (
/obj/effect/turf_decal/box/white/corners,
/obj/structure/closet/crate,
/obj/item/stack/sheet/glass/fifty,
/obj/item/stack/sheet/glass/fifty,
/obj/effect/decal/cleanable/dirt,
/turf/open/floor/plasteel/dark,
/area/shuttle/caravan/freighter4)
"Bu" = (
/obj/item/stack/sheet/mineral/titanium,
/obj/machinery/atmospherics/pipe/manifold/supply/hidden{
	dir = 4
	},
/turf/open/floor/plasteel,
/area/shuttle/caravan/freighter4)
"Bx" = (
/obj/structure/table,
/obj/item/storage/box/donkpockets{
	pixel_x = 6;
	pixel_y = 6
	},
/obj/item/trash/plate{
	pixel_x = -5;
	pixel_y = -3
	},
/obj/effect/decal/cleanable/dirt,
/obj/effect/turf_decal/tile/neutral{
	dir = 1
	},
/obj/effect/turf_decal/tile/neutral,
/obj/effect/turf_decal/tile/neutral{
	dir = 4
	},
/obj/effect/turf_decal/tile/neutral{
	dir = 8
	},
/turf/open/floor/plasteel/dark/airless,
/area/shuttle/caravan/freighter4)
"CR" = (
/obj/effect/turf_decal/bot_white,
/obj/effect/decal/cleanable/dirt,
/obj/machinery/atmospherics/components/unary/vent_pump/on{
	dir = 1
	},
/obj/effect/turf_decal/tile/neutral{
	dir = 1
	},
/obj/effect/turf_decal/tile/neutral,
/obj/effect/turf_decal/tile/neutral{
	dir = 4
	},
/obj/effect/turf_decal/tile/neutral{
	dir = 8
	},
/turf/open/floor/plasteel,
/area/shuttle/caravan/freighter4)
"Dt" = (
/obj/effect/decal/cleanable/dirt,
/obj/machinery/atmospherics/pipe/simple/supply/hidden{
	dir = 10
	},
/obj/effect/turf_decal/tile/yellow{
	dir = 1
	},
/obj/effect/turf_decal/tile/yellow{
	dir = 4
	},
/turf/open/floor/plasteel{
	initial_gas_mix = "TEMP=2.7"
	},
/area/shuttle/caravan/freighter4)
"DQ" = (
/obj/effect/turf_decal/box/white/corners{
	dir = 4
	},
/obj/effect/decal/cleanable/dirt,
/obj/structure/closet/crate,
/obj/item/stack/sheet/mineral/gold{
	amount = 25
	},
/turf/open/floor/plasteel/dark,
/area/shuttle/caravan/freighter4)
"El" = (
/turf/closed/wall/mineral/titanium/nodiagonal,
/area/shuttle/caravan/freighter4)
"EI" = (
/obj/effect/turf_decal/tile/blue{
	dir = 4
	},
/turf/open/floor/plasteel/dark{
	initial_gas_mix = "TEMP=2.7"
	},
/area/shuttle/caravan/freighter4)
"EQ" = (
/obj/machinery/light/small{
	dir = 4
	},
/obj/machinery/firealarm{
	dir = 4;
	pixel_x = 24
	},
/obj/machinery/atmospherics/components/unary/vent_pump/on{
	dir = 8
	},
/obj/effect/turf_decal/tile/yellow{
	dir = 4
	},
/turf/open/floor/plasteel{
	initial_gas_mix = "TEMP=2.7"
	},
/area/shuttle/caravan/freighter4)
"EW" = (
/obj/structure/table/reinforced,
/obj/machinery/button/door{
	id = "caravantrade1_bridge";
	name = "Ship Blast Door Control"
	},
/obj/effect/turf_decal/tile/blue{
	dir = 1
	},
/obj/effect/turf_decal/tile/blue,
/obj/effect/turf_decal/tile/blue{
	dir = 4
	},
/turf/open/floor/plasteel/dark{
	initial_gas_mix = "TEMP=2.7"
	},
/area/shuttle/caravan/freighter4)
"EZ" = (
/obj/effect/turf_decal/tile/neutral{
	dir = 1
	},
/obj/effect/turf_decal/tile/neutral,
/obj/effect/turf_decal/tile/neutral{
	dir = 4
	},
/obj/effect/turf_decal/tile/neutral{
	dir = 8
	},
/turf/open/floor/plasteel/dark,
/area/shuttle/caravan/freighter4)
"Fv" = (
/turf/closed/wall/mineral/titanium,
/area/shuttle/caravan/freighter4)
"Fx" = (
/obj/structure/fluff/broken_flooring{
	icon_state = "singular"
	},
/turf/open/floor/plasteel,
/area/shuttle/caravan/freighter4)
"GJ" = (
/obj/machinery/firealarm{
	pixel_y = 24
	},
/obj/machinery/atmospherics/pipe/manifold/supply/hidden{
	dir = 1
	},
/turf/open/floor/plasteel,
/area/shuttle/caravan/freighter4)
"Hv" = (
/obj/machinery/atmospherics/pipe/manifold/supply/hidden{
	dir = 8
	},
/turf/open/floor/plasteel,
/area/shuttle/caravan/freighter4)
"Ib" = (
/obj/machinery/light/small{
	dir = 1
	},
/obj/machinery/airalarm/all_access{
	pixel_y = 24
	},
/obj/machinery/atmospherics/pipe/simple/supply/hidden{
	dir = 4
	},
/turf/open/floor/plasteel/airless,
/area/shuttle/caravan/freighter4)
"Ja" = (
/obj/machinery/light/small{
	dir = 8
	},
/obj/effect/decal/cleanable/dirt,
/obj/structure/rack,
/obj/item/storage/firstaid/regular,
/obj/effect/turf_decal/tile/blue{
	dir = 1
	},
/obj/effect/turf_decal/tile/blue,
/obj/effect/turf_decal/tile/blue{
	dir = 8
	},
/turf/open/floor/plasteel/dark{
	initial_gas_mix = "TEMP=2.7"
	},
/area/shuttle/caravan/freighter4)
"Jv" = (
/turf/template_noop,
/area/template_noop)
"Ko" = (
/obj/structure/rack,
/obj/item/tank/internals/oxygen,
/obj/item/radio,
/obj/item/clothing/mask/gas,
/obj/effect/turf_decal/tile/blue{
	dir = 4
	},
/turf/open/floor/plasteel{
	initial_gas_mix = "TEMP=2.7"
	},
/area/shuttle/caravan/freighter4)
"KC" = (
/obj/structure/shuttle/engine/propulsion/burst/right{
	dir = 8
	},
/turf/open/floor/plating/airless,
/area/shuttle/caravan/freighter4)
"KX" = (
/obj/structure/shuttle/engine/propulsion/burst/left{
	dir = 8
	},
/turf/open/floor/plating/airless,
/area/shuttle/caravan/freighter4)
"LK" = (
/obj/machinery/suit_storage_unit/standard_unit,
/obj/effect/decal/cleanable/dirt,
/turf/open/floor/plasteel,
/area/shuttle/caravan/freighter4)
"LM" = (
/obj/effect/spawner/structure/window/shuttle,
/obj/machinery/door/poddoor{
	id = "caravantrade1_bridge"
	},
/turf/open/floor/plating,
/area/shuttle/caravan/freighter4)
"LX" = (
/obj/machinery/door/firedoor,
/obj/machinery/atmospherics/pipe/simple/supply/hidden{
	dir = 1
	},
/obj/machinery/door/airlock/engineering{
	name = "Engine Room"
	},
/turf/open/floor/plasteel,
/area/shuttle/caravan/freighter4)
"Mb" = (
/obj/machinery/light/small,
/obj/effect/decal/cleanable/dirt,
/obj/machinery/atmospherics/pipe/simple/supply/hidden{
	dir = 4
	},
/turf/open/floor/plasteel,
/area/shuttle/caravan/freighter4)
"NL" = (
/obj/structure/table,
/obj/machinery/microwave{
	pixel_y = 5
	},
/obj/effect/turf_decal/tile/neutral{
	dir = 1
	},
/obj/effect/turf_decal/tile/neutral,
/obj/effect/turf_decal/tile/neutral{
	dir = 4
	},
/obj/effect/turf_decal/tile/neutral{
	dir = 8
	},
/turf/open/floor/plasteel/dark/airless,
/area/shuttle/caravan/freighter4)
"Od" = (
/obj/effect/decal/cleanable/dirt,
/obj/structure/table/reinforced,
/obj/item/paper_bin{
	pixel_x = 6;
	pixel_y = 6
	},
/obj/item/pen{
	pixel_x = 6;
	pixel_y = 6
	},
/obj/item/folder/yellow{
	pixel_x = -6
	},
/obj/item/gps{
	gpstag = "Distress Signal"
	},
/obj/effect/turf_decal/tile/blue,
/obj/effect/turf_decal/tile/blue{
	dir = 4
	},
/obj/effect/turf_decal/tile/blue{
	dir = 8
	},
/turf/open/floor/plasteel/dark{
	initial_gas_mix = "TEMP=2.7"
	},
/area/shuttle/caravan/freighter4)
"Ow" = (
/obj/effect/decal/cleanable/dirt,
/obj/effect/turf_decal/tile/blue{
	dir = 1
	},
/obj/effect/turf_decal/tile/blue,
/obj/effect/turf_decal/tile/blue{
	dir = 8
	},
/obj/machinery/computer/shuttle/merchant{
	dir = 8
	},
/turf/open/floor/plasteel/dark{
	initial_gas_mix = "TEMP=2.7"
	},
/area/shuttle/caravan/freighter4)
"OK" = (
/obj/effect/turf_decal/box/white/corners{
	dir = 1
	},
/obj/structure/closet/crate,
/obj/item/stack/sheet/mineral/uranium{
	amount = 10
	},
/obj/item/stack/sheet/mineral/uranium{
	amount = 10
	},
/obj/effect/decal/cleanable/dirt,
/turf/open/floor/plasteel/dark,
/area/shuttle/caravan/freighter4)
"PM" = (
/obj/machinery/light/small,
/obj/effect/decal/cleanable/dirt,
/obj/machinery/airalarm/all_access{
	dir = 8;
	pixel_x = 24
	},
/obj/machinery/button/door{
	id = "caravantrade1_cabin2";
	name = "Cabin Bolt Control";
	normaldoorcontrol = 1;
	pixel_x = -25;
	pixel_y = 6;
	specialfunctions = 4
	},
/obj/machinery/atmospherics/components/unary/vent_pump/on{
	dir = 1
	},
/obj/effect/turf_decal/tile/neutral{
	dir = 1
	},
/obj/effect/turf_decal/tile/neutral,
/obj/effect/turf_decal/tile/neutral{
	dir = 4
	},
/obj/effect/turf_decal/tile/neutral{
	dir = 8
	},
/obj/effect/mob_spawn/human/merchant,
/turf/open/floor/plasteel/dark,
/area/shuttle/caravan/freighter4)
"Qk" = (
/obj/machinery/atmospherics/pipe/simple/supply/hidden{
	dir = 10
	},
/turf/open/floor/plasteel,
/area/shuttle/caravan/freighter4)
"Qs" = (
/obj/machinery/light/small{
	dir = 4
	},
/obj/machinery/power/apc{
	dir = 4;
	name = "Small Freighter APC";
	pixel_x = 24;
	start_charge = 0
	},
/obj/effect/decal/cleanable/dirt,
/obj/machinery/atmospherics/pipe/simple/supply/hidden,
/obj/structure/cable,
/turf/open/floor/plating,
/area/shuttle/caravan/freighter4)
"QY" = (
/obj/structure/table,
/obj/machinery/cell_charger,
/obj/machinery/firealarm{
	pixel_y = 24
	},
/obj/item/stack/cable_coil{
	pixel_x = 12;
	pixel_y = 4
	},
/turf/open/floor/plasteel,
/area/shuttle/caravan/freighter4)
"Rw" = (
/obj/machinery/door/airlock{
	id_tag = "caravantrade1_cabin2";
	name = "Cabin 2"
	},
/obj/machinery/atmospherics/pipe/simple/supply/hidden,
/obj/effect/turf_decal/tile/neutral{
	dir = 1
	},
/obj/effect/turf_decal/tile/neutral,
/obj/effect/turf_decal/tile/neutral{
	dir = 4
	},
/obj/effect/turf_decal/tile/neutral{
	dir = 8
	},
/turf/open/floor/plasteel/dark,
/area/shuttle/caravan/freighter4)
"RI" = (
/obj/effect/turf_decal/box/white/corners{
	dir = 8
	},
/turf/open/floor/plasteel/dark,
/area/shuttle/caravan/freighter4)
"RN" = (
/obj/effect/turf_decal/bot,
/obj/machinery/space_heater,
/obj/effect/decal/cleanable/dirt,
/obj/machinery/atmospherics/components/unary/vent_pump/on{
	dir = 4
	},
/turf/open/floor/plating,
/area/shuttle/caravan/freighter4)
"Su" = (
/obj/effect/decal/cleanable/dirt,
/turf/open/floor/plasteel/dark,
/area/shuttle/caravan/freighter4)
"Td" = (
/turf/open/floor/plasteel,
/area/shuttle/caravan/freighter4)
"TP" = (
/obj/structure/closet/crate{
	icon_state = "crateopen"
	},
/obj/item/stack/sheet/metal/fifty,
/turf/open/floor/plasteel/dark,
/area/shuttle/caravan/freighter4)
"Ut" = (
/obj/effect/decal/cleanable/dirt,
/turf/open/floor/plasteel,
/area/shuttle/caravan/freighter4)
"UW" = (
/obj/machinery/airalarm/all_access{
	dir = 8;
	pixel_x = 24
	},
/obj/machinery/atmospherics/pipe/simple/supply/hidden,
/turf/open/floor/plating,
/area/shuttle/caravan/freighter4)
"VD" = (
/obj/effect/mapping_helpers/airlock/cyclelink_helper,
/obj/machinery/door/airlock/external{
	id_tag = "caravantrade1_bolt"
	},
/obj/docking_port/mobile{
	callTime = 250;
	dir = 2;
	dwidth = 5;
	height = 11;
	id = "merchant";
	movement_force = list("KNOCKDOWN" = 0, "THROW" = 0);
	name = "Merchant Caravan";
	port_direction = 8;
	preferred_direction = 4;
	width = 21
	},
/turf/open/floor/plating,
/area/shuttle/caravan/freighter4)
"VN" = (
/obj/machinery/atmospherics/pipe/simple/supply/hidden{
	dir = 4
	},
/turf/open/floor/plasteel,
/area/shuttle/caravan/freighter4)
"VT" = (
/obj/effect/decal/cleanable/dirt,
/obj/machinery/atmospherics/pipe/simple/supply/hidden{
	dir = 4
	},
/turf/open/floor/plasteel,
/area/shuttle/caravan/freighter4)
"Wm" = (
/obj/machinery/door/airlock{
	id_tag = "caravantrade1_cabin1";
	name = "Cabin 1"
	},
/obj/effect/decal/cleanable/dirt,
/obj/machinery/atmospherics/pipe/simple/supply/hidden,
/obj/effect/turf_decal/tile/neutral{
	dir = 1
	},
/obj/effect/turf_decal/tile/neutral,
/obj/effect/turf_decal/tile/neutral{
	dir = 4
	},
/obj/effect/turf_decal/tile/neutral{
	dir = 8
	},
/turf/open/floor/plasteel/dark,
/area/shuttle/caravan/freighter4)
"WU" = (
/obj/machinery/airalarm/all_access{
	dir = 4;
	pixel_x = -24
	},
/obj/effect/decal/cleanable/dirt,
/obj/machinery/atmospherics/pipe/simple/supply/hidden,
/turf/open/floor/plasteel/airless,
/area/shuttle/caravan/freighter4)
"WX" = (
/obj/effect/turf_decal/box/white/corners{
	dir = 8
	},
/obj/structure/closet/crate,
/obj/item/stack/sheet/plasteel/twenty,
/obj/item/stack/sheet/plasteel/twenty,
/turf/open/floor/plasteel/dark,
/area/shuttle/caravan/freighter4)
"WZ" = (
/obj/machinery/power/smes{
	charge = 1.5e6
	},
/obj/effect/turf_decal/stripes/line{
	dir = 4
	},
/obj/structure/cable,
/obj/effect/decal/cleanable/dirt,
/turf/open/floor/plating,
/area/shuttle/caravan/freighter4)
"Xh" = (
/obj/machinery/door/poddoor{
	id = "merchant_cargo";
	name = "Cargo Blast Door"
	},
/obj/effect/decal/cleanable/dirt,
/turf/open/floor/plating/airless,
/area/shuttle/caravan/freighter4)
"Xt" = (
/obj/machinery/atmospherics/pipe/simple/supply/hidden{
	dir = 9
	},
/turf/open/floor/plasteel/airless/dark,
/area/shuttle/caravan/freighter4)
"XI" = (
/obj/effect/turf_decal/bot_white,
/obj/structure/closet/emcloset,
/obj/effect/turf_decal/tile/neutral{
	dir = 1
	},
/obj/effect/turf_decal/tile/neutral,
/obj/effect/turf_decal/tile/neutral{
	dir = 4
	},
/obj/effect/turf_decal/tile/neutral{
	dir = 8
	},
/turf/open/floor/plasteel/dark/airless,
/area/shuttle/caravan/freighter4)
"Zk" = (
/obj/machinery/atmospherics/components/unary/vent_pump/on{
	dir = 1
	},
/obj/effect/turf_decal/tile/neutral{
	dir = 1
	},
/obj/effect/turf_decal/tile/neutral,
/obj/effect/turf_decal/tile/neutral{
	dir = 4
	},
/obj/effect/turf_decal/tile/neutral{
	dir = 8
	},
/turf/open/floor/plasteel/dark,
/area/shuttle/caravan/freighter4)
"ZZ" = (
/obj/effect/turf_decal/box/white/corners{
	dir = 1
	},
/obj/structure/closet/crate,
/obj/item/stack/sheet/rglass{
	amount = 20
	},
/obj/item/stack/sheet/rglass{
	amount = 20
	},
/turf/open/floor/plasteel/dark,
/area/shuttle/caravan/freighter4)

(1,1,1) = {"
Jv
KX
vt
vt
vt
KC
Fv
Jv
Jv
Jv
Jv
"}
(2,1,1) = {"
Fv
mo
mo
mo
mo
mo
El
KX
vt
KC
Jv
"}
(3,1,1) = {"
El
RN
lC
WZ
lt
zd
El
mo
mo
mo
Fv
"}
(4,1,1) = {"
El
oj
ec
Qs
UW
fk
El
OK
ax
tg
El
"}
(5,1,1) = {"
El
ur
El
El
El
ur
El
DQ
Ax
bI
El
"}
(6,1,1) = {"
El
GJ
Rw
PM
El
Qk
rF
Zk
EZ
EZ
Xh
"}
(7,1,1) = {"
LM
Mb
El
El
El
ss
VN
ZZ
Su
RI
Xh
"}
(8,1,1) = {"
El
bg
Wm
uA
Fv
sf
VT
ot
Su
AX
Xh
"}
(9,1,1) = {"
El
bu
El
El
El
QY
VN
Ax
yn
Su
Xh
"}
(10,1,1) = {"
El
cx
El
bR
El
ap
VN
lx
TP
WX
Xh
"}
(11,1,1) = {"
LM
pR
El
jg
El
El
VN
xz
Ut
Td
El
"}
(12,1,1) = {"
LM
Dt
WU
Hv
rF
LX
Bu
CR
Fx
Td
El
"}
(13,1,1) = {"
LM
gs
cX
EQ
VT
El
XI
Ut
Td
El
El
"}
(14,1,1) = {"
El
NL
Bx
El
aP
El
El
El
El
El
Jv
"}
(15,1,1) = {"
El
El
El
El
Ib
LK
El
Jv
Jv
Jv
Jv
"}
(16,1,1) = {"
VD
lM
si
yC
qp
Ko
LM
Jv
Jv
Jv
Jv
"}
(17,1,1) = {"
Fv
El
El
El
AM
El
El
Jv
Jv
Jv
Jv
"}
(18,1,1) = {"
Jv
El
Ja
qM
Xt
mw
El
Jv
Jv
Jv
Jv
"}
(19,1,1) = {"
Jv
LM
Od
EI
gw
EW
LM
Jv
Jv
Jv
Jv
"}
(20,1,1) = {"
Jv
LM
LM
mZ
Ow
LM
LM
Jv
Jv
Jv
Jv
"}
(21,1,1) = {"
Jv
Jv
LM
LM
LM
LM
Jv
Jv
Jv
Jv
Jv
"}
